20 20 46
10 17
0 0 0
0 0 0
0 0 0
0 0 0
0 0 0
0 0 0
0 0 0
0 0 0
0 0 0
....................
....................
....................
....................
.....           ....
.....           ....
.....yyyyyyyyyyyy...
.....y..=......|y...
.....y...CCC...|y...
.....y.t....t.t=y...
.....=..FFtF... y...
.....y.FCFF.C..=y...
.....yC..GGG. C y...
.....yC..GGG. C=y...
.....y.t.GGG... y...
.....y..CFFFC.t|y...
.....y..FFFFF..|y...
.....y= ==F = ==y...
 ....yyyyyyyyyyyy...
....................
